Breakdown,21600,600,210,8256,30666,0.419722222222222
Breakdown,21600,654,124,4710,27088,0.254074074074074
Breakdown,21600,600,90,1064,23354,0.081203703703704
Breakdown,21600,600,270,8568,31038,0.436944444444444
Breakdown,21600,600,90,2128,24418,0.130462962962963
Breakdown,21600,600,270,4570,27040,0.251851851851852
Breakdown,21600,600,210,7492,29902,0.384351851851852
Breakdown,21600,600,210,7176,29586,0.369722222222222
Breakdown,21600,600,270,9012,31482,0.4575
Breakdown,21600,600,120,3952,26272,0.216296296296296
Breakdown,21600,600,270,8778,31248,0.446666666666667
Breakdown,21600,624,302,9356,31882,0.476018518518518
Breakdown,21600,600,270,7252,29722,0.376018518518519
Breakdown,21600,600,240,5406,27846,0.289166666666667
Breakdown,21600,600,270,8964,31434,0.455277777777778
Breakdown,21600,600,180,4502,26882,0.244537037037037
Breakdown,21600,600,330,8244,30774,0.424722222222222
Breakdown,21600,600,240,6162,28602,0.324166666666667
Breakdown,21600,600,180,5560,27940,0.293518518518519
Breakdown,21600,604,122,4450,26776,0.23962962962963
Breakdown,21600,600,270,5998,28468,0.317962962962963
Breakdown,21600,600,150,4612,26962,0.248240740740741
Breakdown,21600,600,150,6490,28840,0.335185185185185
Breakdown,21600,600,240,7694,30134,0.395092592592593
Breakdown,21600,600,150,5180,27530,0.274537037037037
Breakdown,21600,600,300,8894,31394,0.453425925925926
Breakdown,21600,600,120,3436,25756,0.192407407407407
Breakdown,21600,600,270,7634,30104,0.393703703703704
Breakdown,21600,600,300,10216,32716,0.51462962962963
Breakdown,21600,600,180,4760,27140,0.256481481481481
Breakdown,21600,600,270,7824,30294,0.4025
Breakdown,21600,600,150,6148,28498,0.319351851851852
Breakdown,21600,600,150,5152,27502,0.273240740740741
Breakdown,21600,600,210,5424,27834,0.288611111111111
Breakdown,21600,600,240,5830,28270,0.308796296296296
Breakdown,21600,600,240,7424,29864,0.382592592592593
Breakdown,21600,600,270,8764,31234,0.446018518518519
Breakdown,21600,600,300,10294,32794,0.518240740740741
Breakdown,21600,600,420,8910,31530,0.459722222222222
Breakdown,21600,600,150,4556,26906,0.245648148148148
Breakdown,21600,600,330,8278,30808,0.426296296296296
Breakdown,21600,600,240,5806,28246,0.307685185185185
Breakdown,21600,648,242,7874,30364,0.405740740740741
Breakdown,21600,600,180,3934,26314,0.218240740740741
Breakdown,21600,600,90,1316,23606,0.09287037037037
Breakdown,21600,600,210,8126,30536,0.413703703703704
Breakdown,21600,644,272,8834,31350,0.451388888888889
Breakdown,21600,600,360,9336,31896,0.476666666666667
Breakdown,21600,600,180,3432,25812,0.195
Breakdown,21600,600,270,7838,30308,0.403148148148148
Breakdown,21600,600,240,7808,30248,0.40037037037037
Breakdown,21600,656,242,7906,30404,0.407592592592593
Breakdown,21600,600,270,6558,29028,0.343888888888889
Breakdown,21600,600,90,3578,25868,0.197592592592593
Breakdown,21600,600,180,4518,26898,0.245277777777778
Breakdown,21600,600,360,10826,33386,0.545648148148148
Breakdown,21600,600,270,7026,29496,0.365555555555556
Breakdown,21600,600,180,4380,26760,0.238888888888889
Breakdown,21600,600,120,2576,24896,0.152592592592593
Breakdown,21600,600,210,5028,27438,0.270277777777778
Breakdown,21600,600,90,3242,25532,0.182037037037037
Breakdown,21600,618,242,5986,28446,0.316944444444444
Breakdown,21600,600,180,5160,27540,0.275
Breakdown,21600,600,240,7288,29728,0.376296296296296
Breakdown,21600,600,420,13190,35810,0.65787037037037
Breakdown,21600,600,180,5700,28080,0.3
Breakdown,21600,600,60,1408,23668,0.095740740740741
Breakdown,21600,600,120,2612,24932,0.154259259259259
Breakdown,21600,600,210,6322,28732,0.330185185185185
Breakdown,21600,600,60,2330,24590,0.138425925925926
Breakdown,21600,600,390,13342,35932,0.663518518518518
Breakdown,21600,600,90,2294,24584,0.138148148148148
Breakdown,21600,600,210,4466,26876,0.244259259259259
Breakdown,21600,600,240,7830,30270,0.401388888888889
Breakdown,21600,634,182,4988,27404,0.268703703703704
Breakdown,21600,600,270,6240,28710,0.329166666666667
Breakdown,21600,600,150,3264,25614,0.185833333333333
Breakdown,21600,600,270,7168,29638,0.37212962962963
Breakdown,21600,652,92,2308,24652,0.141296296296296
Breakdown,21600,600,180,7454,29834,0.381203703703704
Breakdown,21600,600,420,11312,33932,0.570925925925926
Breakdown,21600,600,180,5810,28190,0.305092592592593
Breakdown,21600,600,180,5150,27530,0.274537037037037
Breakdown,21600,600,120,2718,25038,0.159166666666667
Breakdown,21600,600,330,10536,33066,0.530833333333333
Breakdown,21600,600,150,3258,25608,0.185555555555556
Breakdown,21600,600,150,3740,26090,0.20787037037037
Breakdown,21600,600,150,2954,25304,0.171481481481481
Breakdown,21600,600,270,6702,29172,0.350555555555556
Breakdown,21600,600,210,3580,25990,0.203240740740741
Breakdown,21600,616,242,9910,32368,0.498518518518519
Breakdown,21600,600,240,6370,28810,0.333796296296296
Breakdown,21600,600,240,7110,29550,0.368055555555556
Breakdown,21600,600,480,13304,35984,0.665925925925926
Breakdown,21600,600,180,3910,26290,0.21712962962963
Breakdown,21600,658,242,6750,29250,0.354166666666667
Breakdown,21600,600,180,6316,28696,0.328518518518519
Breakdown,21600,604,92,1454,23750,0.099537037037037
Breakdown,21600,600,330,10274,32804,0.518703703703704
Breakdown,21600,600,210,8632,31042,0.43712962962963
Breakdown,21600,616,242,8446,30904,0.430740740740741
Breakdown,21600,600,120,3908,26228,0.214259259259259
Breakdown,21600,600,240,6480,28920,0.338888888888889
Breakdown,21600,600,90,890,23180,0.073148148148148
Breakdown,21600,600,90,2046,24336,0.126666666666667
Breakdown,21600,600,150,1410,23760,0.1
Breakdown,21600,600,150,5986,28336,0.311851851851852
Breakdown,21600,600,180,5004,27384,0.267777777777778
Breakdown,21600,600,330,6230,28760,0.331481481481481
Breakdown,21600,602,92,2564,24858,0.150833333333333
Breakdown,21600,600,360,8028,30588,0.416111111111111
Breakdown,21600,600,390,13154,35744,0.654814814814815
Breakdown,21600,600,360,13010,35570,0.646759259259259
Breakdown,21600,600,60,1210,23470,0.086574074074074
Breakdown,21600,610,242,3652,26104,0.208518518518518
Breakdown,21600,604,242,5768,28214,0.306203703703704
Breakdown,21600,600,180,3488,25868,0.197592592592593
Breakdown,21600,600,360,10100,32660,0.512037037037037
Breakdown,21600,600,180,4314,26694,0.235833333333333
Breakdown,21600,600,270,8092,30562,0.414907407407407
Breakdown,21600,600,330,7674,30204,0.398333333333333
Breakdown,21600,600,210,7188,29598,0.370277777777778
Breakdown,21600,664,64,570,22898,0.060092592592593
Breakdown,21600,600,90,1934,24224,0.121481481481481
Breakdown,21600,600,210,5784,28194,0.305277777777778
Breakdown,21600,600,300,8308,30808,0.426296296296296
Breakdown,21600,600,90,2560,24850,0.150462962962963
Breakdown,21600,600,210,5914,28324,0.311296296296296
Breakdown,21600,600,450,13410,36060,0.669444444444444
Breakdown,21600,600,180,4962,27342,0.265833333333333
Breakdown,21600,600,210,4302,26712,0.236666666666667
Breakdown,21600,600,210,6130,28540,0.321296296296296
Breakdown,21600,600,150,3306,25656,0.187777777777778
Breakdown,21600,600,450,11012,33662,0.558425925925926
Breakdown,21600,600,90,3424,25714,0.190462962962963
Breakdown,21600,600,300,9056,31556,0.460925925925926
Breakdown,21600,600,180,7152,29532,0.367222222222222
Breakdown,21600,640,272,7594,30106,0.393796296296296
Breakdown,21600,606,422,9052,31680,0.466666666666667
Breakdown,21600,600,120,4654,26974,0.248796296296296
Breakdown,21600,600,240,8544,30984,0.434444444444444
Breakdown,21600,600,180,3258,25638,0.186944444444444
Breakdown,21600,600,240,7642,30082,0.392685185185185
Breakdown,21600,600,240,6718,29158,0.349907407407407
Breakdown,21600,600,150,2670,25020,0.158333333333333
Breakdown,21600,600,30,784,23014,0.065462962962963
Breakdown,21600,600,240,6982,29422,0.36212962962963
Breakdown,21600,600,120,3038,25358,0.173981481481481
Breakdown,21600,600,390,11126,33716,0.560925925925926
Breakdown,21600,600,180,8384,30764,0.424259259259259
Breakdown,21600,600,300,8818,31318,0.449907407407407
Breakdown,21600,600,480,18160,40840,0.890740740740741
Breakdown,21600,602,272,5870,28344,0.312222222222222
Breakdown,21600,620,212,7028,29460,0.363888888888889
Breakdown,21600,600,120,4060,26380,0.221296296296296
Breakdown,21600,600,360,8534,31094,0.439537037037037
Breakdown,21600,600,210,5510,27920,0.292592592592593
Breakdown,21600,600,240,5892,28332,0.311666666666667
Breakdown,21600,600,120,2686,25006,0.157685185185185
Breakdown,21600,600,180,4648,27028,0.251296296296296
Breakdown,21600,600,60,2390,24650,0.141203703703704
Breakdown,21600,600,780,25638,48618,1.25083333333333
Breakdown,21600,600,210,7784,30194,0.39787037037037
Breakdown,21600,600,330,12946,35476,0.642407407407407
Breakdown,21600,600,450,13244,35894,0.661759259259259
Breakdown,21600,600,180,5564,27944,0.293703703703704
Breakdown,21600,600,480,12196,34876,0.61462962962963
Breakdown,21600,600,300,9196,31696,0.467407407407407
Breakdown,21600,600,210,3148,25558,0.183240740740741
Breakdown,21600,600,240,6848,29288,0.355925925925926
Breakdown,21600,600,240,8308,30748,0.423518518518519
Breakdown,21600,600,120,3904,26224,0.214074074074074
Breakdown,21600,600,30,710,22940,0.062037037037037
Breakdown,21600,600,330,10056,32586,0.508611111111111
Breakdown,21600,600,210,7414,29824,0.380740740740741
Breakdown,21600,600,300,6806,29306,0.356759259259259
Breakdown,21600,600,150,4870,27220,0.260185185185185
Breakdown,21600,600,210,7194,29604,0.370555555555556
Breakdown,21600,622,362,13952,36536,0.691481481481481
Breakdown,21600,600,570,16762,39532,0.830185185185185
Breakdown,21600,600,180,5514,27894,0.291388888888889
Breakdown,21600,600,120,2972,25292,0.170925925925926
Breakdown,21600,600,120,2462,24782,0.147314814814815
Breakdown,21600,600,150,4102,26452,0.22462962962963
Breakdown,21600,600,390,16620,39210,0.815277777777778
Breakdown,21600,600,90,3958,26248,0.215185185185185
Breakdown,21600,600,330,11604,34134,0.580277777777778
Breakdown,21600,646,182,7612,30040,0.390740740740741
Breakdown,21600,600,510,15602,38312,0.773703703703704
Breakdown,21600,600,210,2878,25288,0.170740740740741
Breakdown,21600,600,120,2108,24428,0.130925925925926
Breakdown,21600,600,300,7444,29944,0.386296296296296
Breakdown,21600,600,240,7026,29466,0.364166666666667
Breakdown,21600,600,180,5938,28318,0.311018518518518
Breakdown,21600,600,60,844,23104,0.06962962962963
Breakdown,21600,600,210,5844,28254,0.308055555555556
Breakdown,21600,600,210,9028,31438,0.455462962962963
Breakdown,21600,600,90,1646,23936,0.108148148148148
Breakdown,21600,600,240,7220,29660,0.373148148148148
Breakdown,21600,620,62,1252,23534,0.089537037037037
Breakdown,21600,600,120,2390,24710,0.143981481481482
Breakdown,21600,600,390,8788,31378,0.452685185185185
Breakdown,21600,600,240,7152,29592,0.37
Breakdown,21600,600,150,3828,26178,0.211944444444444
Breakdown,21600,600,90,2630,24920,0.153703703703704
Breakdown,21600,600,240,7370,29810,0.380092592592593
Breakdown,21600,600,150,3938,26288,0.217037037037037
Breakdown,21600,600,180,6878,29258,0.354537037037037
Breakdown,21600,600,120,2708,25028,0.158703703703704
Breakdown,21600,640,182,5338,27760,0.285185185185185
Breakdown,21600,600,210,6988,29398,0.361018518518518
Breakdown,21600,600,240,5396,27836,0.288703703703704
Breakdown,21600,600,300,9794,32294,0.495092592592593
Breakdown,21600,600,120,3694,26014,0.204351851851852
Breakdown,21600,600,300,6432,28932,0.339444444444444
Breakdown,21600,600,240,4524,26964,0.248333333333333
Breakdown,21600,604,122,2680,25006,0.157685185185185
Breakdown,21600,600,480,13156,35836,0.659074074074074
Breakdown,21600,628,212,6384,28824,0.334444444444444
Breakdown,21600,600,240,5132,27572,0.276481481481481
Breakdown,21600,600,300,8494,30994,0.434907407407407
Breakdown,21600,600,210,8590,31000,0.435185185185185
Breakdown,21600,644,152,5092,27488,0.272592592592593
Breakdown,21600,600,300,5976,28476,0.318333333333333
Breakdown,21600,600,180,7348,29728,0.376296296296296
Breakdown,21600,600,60,1234,23494,0.087685185185185
Breakdown,21600,600,180,2650,25030,0.158796296296296
Breakdown,21600,600,330,11236,33766,0.563240740740741
Breakdown,21600,600,240,7504,29944,0.386296296296296
Breakdown,21600,600,300,9384,31884,0.476111111111111
Breakdown,21600,600,360,7318,29878,0.383240740740741
Breakdown,21600,600,150,4252,26602,0.231574074074074
Breakdown,21600,600,120,2990,25310,0.171759259259259
Breakdown,21600,600,390,7740,30330,0.404166666666667
Breakdown,21600,600,120,3506,25826,0.195648148148148
Breakdown,21600,600,150,5368,27718,0.283240740740741
Breakdown,21600,600,150,3102,25452,0.178333333333333
Breakdown,21600,600,210,5812,28222,0.306574074074074
Breakdown,21600,600,210,5372,27782,0.286203703703704
Breakdown,21600,614,182,4598,26994,0.249722222222222
Breakdown,21600,600,390,9652,32242,0.492685185185185
Breakdown,21600,600,240,5500,27940,0.293518518518519
Breakdown,21600,634,332,5698,28264,0.308518518518518
Breakdown,21600,600,330,8080,30610,0.41712962962963
Breakdown,21600,600,180,4986,27366,0.266944444444444
Breakdown,21600,600,90,1532,23822,0.10287037037037
Breakdown,21600,600,300,8730,31230,0.445833333333333
Breakdown,21600,600,120,4234,26554,0.229351851851852
Breakdown,21600,600,300,8586,31086,0.439166666666667
Breakdown,21600,600,360,8608,31168,0.442962962962963
Breakdown,21600,600,330,4132,26662,0.234351851851852
Breakdown,21600,600,450,12206,34856,0.613703703703704
Breakdown,21600,600,390,11838,34428,0.593888888888889
Breakdown,21600,600,300,9532,32032,0.482962962962963
Breakdown,21600,600,90,4114,26404,0.222407407407407
Breakdown,21600,600,120,4588,26908,0.245740740740741
Breakdown,21600,600,240,5886,28326,0.311388888888889
Breakdown,21600,600,390,8014,30604,0.416851851851852
Breakdown,21600,600,300,6002,28502,0.319537037037037
Breakdown,21600,600,300,8184,30684,0.420555555555556
Breakdown,21600,600,240,9142,31582,0.46212962962963
Breakdown,21600,630,242,7556,30028,0.390185185185185
Breakdown,21600,600,270,9506,31976,0.48037037037037
Breakdown,21600,600,270,10884,33354,0.544166666666667
Breakdown,21600,600,270,5732,28202,0.305648148148148
Breakdown,21600,600,270,7092,29562,0.368611111111111
Breakdown,21600,600,90,1852,24142,0.117685185185185
Breakdown,21600,600,240,8892,31332,0.450555555555556
Breakdown,21600,600,210,6860,29270,0.355092592592593
Breakdown,21600,600,210,6614,29024,0.343703703703704
Breakdown,21600,600,270,6612,29082,0.346388888888889
Breakdown,21600,600,90,1710,24000,0.111111111111111
Breakdown,21600,600,330,7332,29862,0.3825
Breakdown,21600,600,240,7604,30044,0.390925925925926
Breakdown,21600,600,180,6570,28950,0.340277777777778
Breakdown,21600,600,60,1778,24038,0.11287037037037
Breakdown,21600,658,92,4238,26588,0.230925925925926
Breakdown,21600,630,92,3070,25392,0.175555555555556
Breakdown,21600,600,420,13180,35800,0.657407407407407
Breakdown,21600,600,600,16056,38856,0.798888888888889
Breakdown,21600,600,210,4272,26682,0.235277777777778
Breakdown,21600,600,240,11492,33932,0.570925925925926
Breakdown,21600,600,210,5694,28104,0.301111111111111
Breakdown,21600,600,240,4492,26932,0.246851851851852
Breakdown,21600,600,360,11622,34182,0.5825
Breakdown,21600,600,90,3660,25950,0.201388888888889
Breakdown,21600,622,182,6144,28548,0.321666666666667
Breakdown,21600,600,60,2870,25130,0.163425925925926
Breakdown,21600,600,240,10014,32454,0.5025
Breakdown,21600,606,512,13020,35738,0.654537037037037
Breakdown,21600,600,120,3632,25952,0.201481481481481
Breakdown,21600,600,270,8096,30566,0.415092592592593
Breakdown,21600,600,240,7088,29528,0.367037037037037
Breakdown,21600,600,150,3482,25832,0.195925925925926
Breakdown,21600,600,150,5620,27970,0.294907407407407
Breakdown,21600,600,210,8518,30928,0.431851851851852
Breakdown,21600,600,150,4868,27218,0.260092592592593
Breakdown,21600,600,300,8808,31308,0.449444444444444
Breakdown,21600,600,270,9482,31952,0.479259259259259
Breakdown,21600,600,180,6404,28784,0.332592592592593
Breakdown,21600,600,240,6650,29090,0.346759259259259
Breakdown,21600,634,272,6660,29166,0.350277777777778
Breakdown,21600,600,270,10448,32918,0.523981481481482
Breakdown,21600,600,270,6994,29464,0.364074074074074
Breakdown,21600,600,150,5270,27620,0.278703703703704
Breakdown,21600,600,270,7240,29710,0.375462962962963
Breakdown,21600,600,270,9226,31696,0.467407407407407
Breakdown,21600,600,240,7270,29710,0.375462962962963
Breakdown,21600,600,210,5650,28060,0.299074074074074
Breakdown,21600,618,212,7190,29620,0.371296296296296
Breakdown,21600,600,180,5510,27890,0.291203703703704
Breakdown,21600,600,210,4606,27016,0.250740740740741
Breakdown,21600,600,270,6824,29294,0.356203703703704
Breakdown,21600,632,122,1858,24212,0.120925925925926
Breakdown,21600,600,150,2956,25306,0.171574074074074
Breakdown,21600,600,270,7258,29728,0.376296296296296
Breakdown,21600,600,270,8100,30570,0.415277777777778
Breakdown,21600,600,120,3068,25388,0.17537037037037
Breakdown,21600,600,330,8858,31388,0.453148148148148
Breakdown,21600,610,242,8348,30800,0.425925925925926
Breakdown,21600,640,242,6670,29152,0.34962962962963
Breakdown,21600,600,120,2456,24776,0.147037037037037
Breakdown,21600,600,60,2362,24622,0.139907407407407
Breakdown,21600,600,240,6418,28858,0.336018518518518
Breakdown,21600,600,120,4668,26988,0.249444444444444
Breakdown,21600,600,60,1512,23772,0.100555555555556
Breakdown,21600,600,240,4900,27340,0.265740740740741
Breakdown,21600,600,270,4972,27442,0.270462962962963
Breakdown,21600,600,180,3300,25680,0.188888888888889
Breakdown,21600,612,272,7464,29948,0.386481481481481
Breakdown,21600,600,270,7196,29666,0.373425925925926
Breakdown,21600,600,150,3112,25462,0.178796296296296
Breakdown,21600,600,60,1296,23556,0.090555555555556
Breakdown,21600,600,180,6988,29368,0.35962962962963
Breakdown,21600,600,270,6932,29402,0.361203703703704
Breakdown,21600,600,180,6402,28782,0.3325
Breakdown,21600,600,90,1826,24116,0.116481481481481
Breakdown,21600,600,240,8362,30802,0.426018518518519
Breakdown,21600,600,180,5564,27944,0.293703703703704
Breakdown,21600,600,270,7646,30116,0.394259259259259
Breakdown,21600,600,330,11218,33748,0.562407407407407
Breakdown,21600,600,120,2744,25064,0.16037037037037
Breakdown,21600,600,360,11628,34188,0.582777777777778
Breakdown,21600,600,240,6604,29044,0.34462962962963
Breakdown,21600,636,182,5338,27756,0.285
Breakdown,21600,600,150,4226,26576,0.23037037037037
Breakdown,21600,600,60,1996,24256,0.122962962962963
Breakdown,21600,600,390,7742,30332,0.404259259259259
Breakdown,21600,600,180,2716,25096,0.161851851851852
Breakdown,21600,600,360,10344,32904,0.523333333333333
Breakdown,21600,600,210,6906,29316,0.357222222222222
Breakdown,21600,600,210,7398,29808,0.38
Breakdown,21600,600,240,8880,31320,0.45
Breakdown,21600,600,300,9738,32238,0.4925
Breakdown,21600,646,212,8750,31208,0.444814814814815
Breakdown,21600,614,62,846,23122,0.070462962962963
Breakdown,21600,600,390,10900,33490,0.550462962962963
Breakdown,21600,600,210,5672,28082,0.300092592592593
Breakdown,21600,600,180,2372,24752,0.145925925925926
Breakdown,21600,600,330,6666,29196,0.351666666666667
Breakdown,21600,600,210,4852,27262,0.26212962962963
Breakdown,21600,600,240,6870,29310,0.356944444444444
Breakdown,21600,600,210,5964,28374,0.313611111111111
Breakdown,21600,600,150,5522,27872,0.29037037037037
Breakdown,21600,600,210,7030,29440,0.362962962962963
Breakdown,21600,600,330,13492,36022,0.667685185185185
Breakdown,21600,600,300,10506,33006,0.528055555555556
Breakdown,21600,600,90,4038,26328,0.218888888888889
Breakdown,21600,600,180,4958,27338,0.265648148148148
Breakdown,21600,600,210,7136,29546,0.36787037037037
Breakdown,21600,600,210,5646,28056,0.298888888888889
Breakdown,21600,600,180,3306,25686,0.189166666666667
Breakdown,21600,600,90,1840,24130,0.11712962962963
Breakdown,21600,600,360,13090,35650,0.650462962962963
Breakdown,21600,618,242,7474,29934,0.385833333333333
Breakdown,21600,600,60,1194,23454,0.085833333333333
Breakdown,21600,600,270,6884,29354,0.358981481481481
Breakdown,21600,600,120,4128,26448,0.224444444444444
Breakdown,21600,600,150,5466,27816,0.287777777777778
Breakdown,21600,600,510,19396,42106,0.949351851851852
Breakdown,21600,626,122,3714,26062,0.206574074074074
Breakdown,21600,600,420,14766,37386,0.730833333333333
Breakdown,21600,600,150,1766,24116,0.116481481481481
Breakdown,21600,600,240,7742,30182,0.397314814814815
Breakdown,21600,636,242,8614,31092,0.439444444444445
Breakdown,21600,600,180,8004,30384,0.406666666666667
Breakdown,21600,600,270,8740,31210,0.444907407407407
Breakdown,21600,600,270,9270,31740,0.469444444444444
Breakdown,21600,600,120,5192,27512,0.273703703703704
Breakdown,21600,600,270,5314,27784,0.286296296296296
Breakdown,21600,600,240,7352,29792,0.379259259259259
Breakdown,21600,600,180,6600,28980,0.341666666666667
Breakdown,21600,600,330,13296,35826,0.658611111111111
Breakdown,21600,600,150,6002,28352,0.312592592592593
Breakdown,21600,600,150,4228,26578,0.230462962962963
Breakdown,21600,600,330,12562,35092,0.62462962962963
Breakdown,21600,600,270,6256,28726,0.329907407407407
Breakdown,21600,600,300,9960,32460,0.502777777777778
Breakdown,21600,600,90,2774,25064,0.16037037037037
Breakdown,21600,600,210,5858,28268,0.308703703703704
Breakdown,21600,600,180,6342,28722,0.329722222222222
Breakdown,21600,600,210,7414,29824,0.380740740740741
Breakdown,21600,600,240,4860,27300,0.263888888888889
Breakdown,21600,600,150,3764,26114,0.208981481481481
Breakdown,21600,600,120,4210,26530,0.228240740740741
Breakdown,21600,600,300,10070,32570,0.50787037037037
Breakdown,21600,600,240,8360,30800,0.425925925925926
Breakdown,21600,600,90,3402,25692,0.189444444444444
Breakdown,21600,600,210,6974,29384,0.36037037037037
Breakdown,21600,600,120,5172,27492,0.272777777777778
Breakdown,21600,658,182,5888,28328,0.311481481481481
Breakdown,21600,600,420,11594,34214,0.583981481481481
Breakdown,21600,600,180,4766,27146,0.256759259259259
Breakdown,21600,600,150,7170,29520,0.366666666666667
Breakdown,21600,600,270,6688,29158,0.349907407407407
Breakdown,21600,600,360,12296,34856,0.613703703703704
Breakdown,21600,600,210,6668,29078,0.346203703703704
Breakdown,21600,600,90,1774,24064,0.114074074074074
Breakdown,21600,600,210,6542,28952,0.34037037037037
Breakdown,21600,600,210,8838,31248,0.446666666666667
Breakdown,21600,600,390,11102,33692,0.559814814814815
Breakdown,21600,600,300,10438,32938,0.524907407407407
Breakdown,21600,600,150,2098,24448,0.131851851851852
Breakdown,21600,630,302,9260,31792,0.471851851851852
Breakdown,21600,600,150,2862,25212,0.167222222222222
Breakdown,21600,600,270,7728,30198,0.398055555555555
Breakdown,21600,600,300,10612,33112,0.532962962962963
Breakdown,21600,600,120,5260,27580,0.276851851851852
Breakdown,21600,600,180,5124,27504,0.273333333333333
Breakdown,21600,600,420,11582,34202,0.583425925925926
Breakdown,21600,600,180,4834,27214,0.259907407407407
Breakdown,21600,600,330,12544,35074,0.623796296296296
Breakdown,21600,600,180,6520,28900,0.337962962962963
Breakdown,21600,600,270,6242,28712,0.329259259259259
Breakdown,21600,600,420,12998,35618,0.648981481481482
Breakdown,21600,600,120,5546,27866,0.290092592592593
Breakdown,21600,600,180,5682,28062,0.299166666666667
Breakdown,21600,600,300,8556,31056,0.437777777777778
Breakdown,21600,600,240,5298,27738,0.284166666666667
Breakdown,21600,600,420,12880,35500,0.643518518518518
Breakdown,21600,600,570,17570,40340,0.867592592592593
Breakdown,21600,600,150,3184,25534,0.18212962962963
Breakdown,21600,600,180,6212,28592,0.323703703703704
Breakdown,21600,600,270,8152,30622,0.417685185185185
Breakdown,21600,600,180,7082,29462,0.363981481481481
Breakdown,21600,600,210,3082,25492,0.180185185185185
Breakdown,21600,640,274,5120,27634,0.279351851851852
Breakdown,21600,608,272,7068,29548,0.367962962962963
Breakdown,21600,600,360,9394,31954,0.479351851851852
Breakdown,21600,600,390,11212,33802,0.564907407407407
Breakdown,21600,600,240,8486,30926,0.431759259259259
Breakdown,21600,678,154,6320,28752,0.331111111111111
Breakdown,21600,600,420,16300,38920,0.801851851851852
Breakdown,21600,600,60,1262,23522,0.088981481481482
Breakdown,21600,600,480,20776,43456,1.01185185185185
Breakdown,21600,600,180,4024,26404,0.222407407407407
Breakdown,21600,600,330,10028,32558,0.507314814814815
Breakdown,21600,600,210,4198,26608,0.231851851851852
Breakdown,21600,600,300,6668,29168,0.35037037037037
Breakdown,21600,600,330,6792,29322,0.3575
Breakdown,21600,600,120,3196,25516,0.181296296296296
Breakdown,21600,636,152,5168,27556,0.275740740740741
Breakdown,21600,632,122,1822,24176,0.119259259259259
Breakdown,21600,600,210,7706,30116,0.394259259259259
Breakdown,21600,600,660,20308,43168,0.998518518518518
Breakdown,21600,600,180,3954,26334,0.219166666666667
Breakdown,21600,600,150,4596,26946,0.2475
Breakdown,21600,600,150,2674,25024,0.158518518518519
Breakdown,21600,600,120,3106,25426,0.17712962962963
Breakdown,21600,600,180,5350,27730,0.283796296296296
Breakdown,21600,600,360,8486,31046,0.437314814814815
Breakdown,21600,600,210,6150,28560,0.322222222222222
Breakdown,21600,600,180,7094,29474,0.364537037037037
Breakdown,21600,600,330,10970,33500,0.550925925925926
Breakdown,21600,678,244,8760,31282,0.448240740740741
Breakdown,21600,600,210,4048,26458,0.224907407407407
Breakdown,21600,600,180,6536,28916,0.338703703703704
Breakdown,21600,602,122,2522,24846,0.150277777777778
Breakdown,21600,600,90,1582,23872,0.105185185185185
Breakdown,21600,600,390,14036,36626,0.695648148148148
Breakdown,21600,600,180,7500,29880,0.383333333333333
Breakdown,21600,600,210,7420,29830,0.381018518518519
Breakdown,21600,600,360,7260,29820,0.380555555555556
Breakdown,21600,652,182,5142,27576,0.276666666666667
Breakdown,21600,600,420,11986,34606,0.60212962962963
Breakdown,21600,600,180,3858,26238,0.214722222222222
Breakdown,21600,600,150,4856,27206,0.259537037037037
Breakdown,21600,600,210,4988,27398,0.268425925925926
Breakdown,21600,600,120,3330,25650,0.1875
Breakdown,21600,600,180,6948,29328,0.357777777777778
Breakdown,21600,600,210,7860,30270,0.401388888888889
Breakdown,21600,600,240,7796,30236,0.399814814814815
Breakdown,21600,600,360,11828,34388,0.592037037037037
Breakdown,21600,626,512,18754,41492,0.920925925925926
Breakdown,21600,602,212,4146,26560,0.22962962962963
Breakdown,21600,600,150,4930,27280,0.262962962962963
Breakdown,21600,600,210,4780,27190,0.258796296296296
Breakdown,21600,600,210,5274,27684,0.281666666666667
Breakdown,21600,600,510,16724,39434,0.825648148148148
Breakdown,21600,600,120,2598,24918,0.153611111111111
Breakdown,21600,600,180,5282,27662,0.280648148148148
Breakdown,21600,610,272,7812,30294,0.4025
Breakdown,21600,600,660,21542,44402,1.05564814814815
Breakdown,21600,600,210,6526,28936,0.33962962962963
Breakdown,21600,600,90,1312,23602,0.092685185185185
Breakdown,21600,600,240,8282,30722,0.422314814814815
Breakdown,21600,600,180,6364,28744,0.330740740740741
Breakdown,21600,608,272,9428,31908,0.477222222222222
Breakdown,21600,600,390,7128,29718,0.375833333333333
Breakdown,21600,622,62,1108,23392,0.082962962962963
Breakdown,21600,600,120,3852,26172,0.211666666666667
Breakdown,21600,600,240,7210,29650,0.372685185185185
Breakdown,21600,600,210,4348,26758,0.238796296296296
Breakdown,21600,600,210,4296,26706,0.236388888888889
Breakdown,21600,600,270,6522,28992,0.342222222222222
Breakdown,21600,600,270,6240,28710,0.329166666666667
Breakdown,21600,600,180,4008,26388,0.221666666666667
Breakdown,21600,600,90,2212,24502,0.134351851851852
Breakdown,21600,600,210,7644,30054,0.391388888888889
Breakdown,21600,600,240,8010,30450,0.409722222222222
Breakdown,21600,600,330,9756,32286,0.494722222222222
Breakdown,21600,600,180,3240,25620,0.186111111111111
Breakdown,21600,600,270,5680,28150,0.303240740740741
Breakdown,21600,600,270,8594,31064,0.438148148148148
Breakdown,21600,600,210,3814,26224,0.214074074074074
Breakdown,21600,600,270,7612,30082,0.392685185185185
Breakdown,21600,600,120,2236,24556,0.136851851851852
Breakdown,21600,600,90,648,22938,0.061944444444445
Breakdown,21600,600,300,9968,32468,0.503148148148148
Breakdown,21600,600,210,4712,27122,0.255648148148148
Breakdown,21600,600,30,60,22290,0.031944444444445
Breakdown,21600,600,120,3514,25834,0.196018518518519
Breakdown,21600,600,180,3106,25486,0.179907407407407
Breakdown,21600,600,270,4512,26982,0.249166666666667
Breakdown,21600,638,152,5578,27968,0.294814814814815
Breakdown,21600,600,240,4430,26870,0.243981481481481
Breakdown,21600,616,152,1238,23606,0.09287037037037
Breakdown,21600,600,270,7750,30220,0.399074074074074
Breakdown,21600,600,270,7776,30246,0.400277777777778
Breakdown,21600,600,270,8244,30714,0.421944444444444
Breakdown,21600,600,270,9612,32082,0.485277777777778
Breakdown,21600,600,150,2182,24532,0.135740740740741
Breakdown,21600,624,242,6154,28620,0.325
Breakdown,21600,600,330,7768,30298,0.402685185185185
Breakdown,21600,600,120,2014,24334,0.126574074074074
Breakdown,21600,600,240,7492,29932,0.385740740740741
Breakdown,21600,600,240,6256,28696,0.328518518518519
Breakdown,21600,600,270,9054,31524,0.459444444444444
Breakdown,21600,600,360,10754,33314,0.542314814814815
Breakdown,21600,600,180,3356,25736,0.191481481481481
Breakdown,21600,600,270,8142,30612,0.417222222222222
Breakdown,21600,600,150,3538,25888,0.198518518518519
Breakdown,21600,600,120,1784,24104,0.115925925925926
Breakdown,21600,600,30,0,22230,0.029166666666667
Breakdown,21600,600,390,13936,36526,0.691018518518519
Breakdown,21600,600,330,11358,33888,0.568888888888889
Breakdown,21600,680,154,1532,23966,0.109537037037037
Breakdown,21600,656,212,9398,31866,0.475277777777778
Breakdown,21600,658,152,3688,26098,0.208240740740741
Breakdown,21600,658,332,7726,30316,0.403518518518519
Breakdown,21600,600,180,4730,27110,0.255092592592593
Breakdown,21600,650,242,9044,31536,0.46
Breakdown,21600,600,360,11216,33776,0.563703703703704
Breakdown,21600,600,150,3886,26236,0.21462962962963
Breakdown,21600,672,364,6868,29504,0.365925925925926
Breakdown,21600,600,150,3822,26172,0.211666666666667
Breakdown,21600,600,150,4680,27030,0.251388888888889
Breakdown,21600,600,240,6870,29310,0.356944444444444
Breakdown,21600,600,270,5508,27978,0.295277777777778
Breakdown,21600,610,182,6306,28698,0.328611111111111
Breakdown,21600,600,210,7464,29874,0.383055555555556
Breakdown,21600,600,120,1272,23592,0.092222222222222
Breakdown,21600,600,90,2750,25040,0.159259259259259
Breakdown,21600,600,120,3334,25654,0.187685185185185
Breakdown,21600,600,270,7906,30376,0.406296296296296
Breakdown,21600,600,330,5788,28318,0.311018518518518
Breakdown,21600,636,122,3336,25694,0.189537037037037
Breakdown,21600,634,272,5390,27896,0.291481481481481
Breakdown,21600,638,62,2340,24640,0.140740740740741
Breakdown,21600,636,212,4674,27122,0.255648148148148
Breakdown,21600,632,182,7672,30086,0.39287037037037
Breakdown,21600,630,32,750,23012,0.06537037037037
Breakdown,21600,634,182,5518,27934,0.293240740740741
Breakdown,21600,632,92,2536,24860,0.150925925925926
Breakdown,21600,628,272,8858,31358,0.451759259259259
Breakdown,21600,626,152,5852,28230,0.306944444444444
Breakdown,21600,630,122,1900,24252,0.122777777777778
Breakdown,21600,628,302,10182,32712,0.514444444444445
Breakdown,21600,624,32,1410,23666,0.095648148148148
Breakdown,21600,622,212,6826,29260,0.35462962962963
Breakdown,21600,626,62,1324,23612,0.093148148148148
Breakdown,21600,624,152,5478,27854,0.289537037037037
Breakdown,21600,652,212,6486,28950,0.340277777777778
Breakdown,21600,650,182,7138,29570,0.368981481481481
Breakdown,21600,654,122,2322,24698,0.143425925925926
Breakdown,21600,708,154,4750,27212,0.259814814814815
Breakdown,21600,648,152,5404,27804,0.287222222222222
Breakdown,21600,646,242,6406,28894,0.337685185185185
Breakdown,21600,650,272,6326,28848,0.335555555555556
Breakdown,21600,648,62,450,22760,0.053703703703704
Breakdown,21600,644,122,4536,26902,0.245462962962963
Breakdown,21600,642,272,9100,31614,0.463611111111111
Breakdown,21600,646,302,8796,31344,0.451111111111111
Breakdown,21600,644,32,1614,23890,0.106018518518519
Breakdown,21600,694,424,10658,33376,0.545185185185185
Breakdown,21600,638,152,5936,28326,0.311388888888889
Breakdown,21600,642,122,3118,25482,0.179722222222222
Breakdown,21600,640,152,4454,26846,0.24287037037037
Breakdown,21600,604,362,11470,34036,0.575740740740741
Breakdown,21600,602,62,676,22940,0.062037037037037
Breakdown,21600,606,92,2772,25070,0.160648148148148
Breakdown,21600,604,302,10164,32670,0.5125
Breakdown,21600,638,362,11530,34130,0.580092592592593
Breakdown,21600,680,484,13888,36652,0.696851851851852
Breakdown,21600,602,272,12040,34514,0.59787037037037
Breakdown,21600,600,180,4904,27284,0.263148148148148
Breakdown,21600,636,94,5490,27820,0.287962962962963
Breakdown,21600,600,300,8888,31388,0.453148148148148
Breakdown,21600,600,150,6534,28884,0.337222222222222
Breakdown,21600,600,420,13678,36298,0.680462962962963
Breakdown,21600,600,600,15960,38760,0.794444444444444
Breakdown,21600,600,360,13008,35568,0.646666666666667
Breakdown,21600,600,90,2308,24598,0.138796296296296
Breakdown,21600,600,240,8354,30794,0.425648148148148
Breakdown,21600,620,152,5174,27546,0.275277777777778
Breakdown,21600,618,272,5774,28264,0.308518518518518
Breakdown,21600,622,632,14324,37178,0.721203703703704
Breakdown,21600,670,306,9756,32332,0.496851851851852
Breakdown,21600,616,512,15876,38604,0.787222222222222
Breakdown,21600,614,302,5706,28222,0.306574074074074
Breakdown,21600,618,272,6066,28556,0.322037037037037
Breakdown,21600,616,122,3284,25622,0.186203703703704
Breakdown,21600,612,62,3878,26152,0.210740740740741
Breakdown,21600,610,182,3732,26124,0.209444444444444
Breakdown,21600,614,92,4940,27246,0.261388888888889
Breakdown,21600,612,272,8592,31076,0.438703703703704
Breakdown,21600,616,184,5740,28140,0.302777777777778
Breakdown,21600,644,124,4920,27288,0.263333333333333
Breakdown,21600,610,152,4570,26932,0.246851851851852
Breakdown,21600,608,212,4358,26778,0.239722222222222
Breakdown,21600,600,150,4316,26666,0.234537037037037
Breakdown,21600,600,420,11816,34436,0.594259259259259
Breakdown,21600,600,300,9720,32220,0.491666666666667
Breakdown,21600,600,240,5504,27944,0.293703703703704
Breakdown,21600,600,300,7600,30100,0.393518518518519
Breakdown,21600,600,300,8718,31218,0.445277777777778
Breakdown,21600,600,210,2564,24974,0.156203703703704
Breakdown,21600,600,210,6576,28986,0.341944444444444
Breakdown,21600,600,360,7730,30290,0.402314814814815
Breakdown,21600,600,90,2394,24684,0.142777777777778
Breakdown,21600,600,150,5150,27500,0.273148148148148
Breakdown,21600,636,332,11578,34146,0.580833333333333
Breakdown,21600,600,330,11886,34416,0.593333333333333
Breakdown,21600,600,330,7514,30044,0.390925925925926
Breakdown,21600,600,450,14730,37380,0.730555555555555
Breakdown,21600,600,180,2626,25006,0.157685185185185
Breakdown,21600,600,150,4432,26782,0.239907407407407
Breakdown,21600,600,240,7822,30262,0.401018518518518
Breakdown,21600,600,390,10722,33312,0.542222222222222
Breakdown,21600,600,180,5010,27390,0.268055555555556
Breakdown,21600,600,390,12252,34842,0.613055555555556
Breakdown,21600,600,420,13650,36270,0.679166666666667
Breakdown,21600,600,90,2330,24620,0.139814814814815
Breakdown,21600,600,150,2960,25310,0.171759259259259
Breakdown,21600,600,90,2272,24562,0.13712962962963
Breakdown,21600,600,450,10084,32734,0.515462962962963
Breakdown,21600,600,150,3732,26082,0.2075
Breakdown,21600,616,92,772,23080,0.068518518518519
Breakdown,21600,600,300,11556,34056,0.576666666666667
Breakdown,21600,600,120,2554,24874,0.151574074074074
Breakdown,21600,600,210,4364,26774,0.239537037037037
Breakdown,21600,600,180,3852,26232,0.214444444444444
Breakdown,21600,600,90,2754,25044,0.159444444444444
Breakdown,21600,600,120,3108,25428,0.177222222222222
Breakdown,21600,606,122,3706,26034,0.205277777777778
Breakdown,21600,600,300,8194,30694,0.421018518518518
Breakdown,21600,600,330,5934,28464,0.317777777777778
Breakdown,21600,600,180,5394,27774,0.285833333333333
Breakdown,21600,600,450,11400,34050,0.576388888888889
Breakdown,21600,600,360,10502,33062,0.530648148148148
Breakdown,21600,600,240,6658,29098,0.34712962962963
Breakdown,21600,600,240,6610,29050,0.344907407407407
Breakdown,21600,600,300,8366,30866,0.428981481481481
Breakdown,21600,600,90,2424,24714,0.144166666666667
Breakdown,21600,600,180,5558,27938,0.293425925925926
Breakdown,21600,600,210,5654,28064,0.299259259259259
Breakdown,21600,600,150,4336,26686,0.235462962962963
Breakdown,21600,600,240,10286,32726,0.515092592592593
Breakdown,21600,632,182,3236,25650,0.1875
Breakdown,21600,600,390,11814,34404,0.592777777777778
Breakdown,21600,604,92,1936,24232,0.121851851851852
Breakdown,21600,634,304,7626,30164,0.396481481481481
Breakdown,21600,600,360,10026,32586,0.508611111111111
Breakdown,21600,600,150,3980,26330,0.218981481481481
Breakdown,21600,600,180,6288,28668,0.327222222222222
Breakdown,21600,600,210,5674,28084,0.300185185185185
Breakdown,21600,600,420,16586,39206,0.815092592592593
Breakdown,21600,600,180,4144,26524,0.227962962962963
Breakdown,21600,600,300,5332,27832,0.288518518518518
Breakdown,21600,600,180,5622,28002,0.296388888888889
Breakdown,21600,600,240,4370,26810,0.241203703703704
Breakdown,21600,600,300,8772,31272,0.447777777777778
Breakdown,21600,600,330,10374,32904,0.523333333333333
Breakdown,21600,600,150,2320,24670,0.14212962962963
Breakdown,21600,600,420,7492,30112,0.394074074074074
Breakdown,21600,600,210,4126,26536,0.228518518518518
Breakdown,21600,600,60,910,23170,0.072685185185185
Breakdown,21600,608,182,2656,25046,0.159537037037037
Breakdown,21600,600,180,5502,27882,0.290833333333333
Breakdown,21600,600,90,276,22566,0.044722222222222
Breakdown,21600,600,360,7406,29966,0.387314814814815
Breakdown,21600,600,150,3228,25578,0.184166666666667
Breakdown,21600,600,330,7572,30102,0.393611111111111
Breakdown,21600,600,180,3730,26110,0.208796296296296
Breakdown,21600,600,240,5078,27518,0.273981481481481
Breakdown,21600,600,300,5174,27674,0.281203703703704
Breakdown,21600,600,120,3596,25916,0.199814814814815
Breakdown,21600,600,390,9718,32308,0.495740740740741
Breakdown,21600,600,90,2142,24432,0.131111111111111
Breakdown,21600,600,360,9596,32156,0.488703703703704
Breakdown,21600,600,390,6910,29500,0.365740740740741
Breakdown,21600,634,152,4120,26506,0.22712962962963
Breakdown,21600,600,120,3012,25332,0.172777777777778
Breakdown,21600,630,272,6878,29380,0.360185185185185
Breakdown,21600,640,362,8820,31422,0.454722222222222
Breakdown,21600,600,480,17226,39906,0.8475
Breakdown,21600,600,450,10062,32712,0.514444444444445
Breakdown,21600,600,60,1152,23412,0.083888888888889
Breakdown,21600,600,180,4528,26908,0.245740740740741
Breakdown,21600,600,330,5726,28256,0.308148148148148
Breakdown,21600,600,300,8974,31474,0.45712962962963
Breakdown,21600,600,60,2024,24284,0.124259259259259
Breakdown,21600,600,120,2764,25084,0.161296296296296
Breakdown,21600,600,210,6650,29060,0.34537037037037
Breakdown,21600,600,240,4932,27372,0.267222222222222
Breakdown,21600,600,360,11984,34544,0.599259259259259
Breakdown,21600,600,300,10484,32984,0.527037037037037
Breakdown,21600,600,90,2054,24344,0.127037037037037
Breakdown,21600,600,180,4806,27186,0.258611111111111
Breakdown,21600,600,150,4268,26618,0.232314814814815
Breakdown,21600,600,270,9284,31754,0.470092592592593
Breakdown,21600,600,180,2726,25106,0.162314814814815
Breakdown,21600,600,150,3380,25730,0.191203703703704
Breakdown,21600,600,330,11898,34428,0.593888888888889
Breakdown,21600,600,60,1448,23708,0.097592592592593
Breakdown,21600,600,210,5740,28150,0.303240740740741
Breakdown,21600,600,240,7336,29776,0.378518518518519
Breakdown,21600,600,270,6628,29098,0.34712962962963
Breakdown,21600,608,242,7466,29916,0.385
Breakdown,21600,600,210,4306,26716,0.236851851851852
Breakdown,21600,600,210,3714,26124,0.209444444444444
Breakdown,21600,634,182,5944,28360,0.312962962962963
Breakdown,21600,600,180,4616,26996,0.249814814814815
Breakdown,21600,600,360,7680,30240,0.4
Breakdown,21600,600,180,5436,27816,0.287777777777778
Breakdown,21600,600,150,1580,23930,0.10787037037037
Breakdown,21600,600,210,5876,28286,0.309537037037037
Breakdown,21600,656,152,3214,25622,0.186203703703704
Breakdown,21600,600,180,3772,26152,0.210740740740741
Breakdown,21600,600,120,5162,27482,0.272314814814815
Breakdown,21600,600,150,6002,28352,0.312592592592593
Breakdown,21600,626,242,4862,27330,0.265277777777778
Breakdown,21600,600,210,7600,30010,0.389351851851852
Breakdown,21600,600,210,5442,27852,0.289444444444444
Breakdown,21600,600,90,448,22738,0.052685185185185
Breakdown,21600,600,270,7990,30460,0.410185185185185
Breakdown,21600,600,210,6646,29056,0.345185185185185
Breakdown,21600,600,150,2436,24786,0.1475
Breakdown,21600,600,270,9888,32358,0.498055555555556
Breakdown,21600,600,300,10876,33376,0.545185185185185
Breakdown,21600,600,390,14156,36746,0.701203703703704
Breakdown,21600,600,180,1738,24118,0.116574074074074
Breakdown,21600,600,90,2272,24562,0.13712962962963
Breakdown,21600,600,150,2332,24682,0.142685185185185
Breakdown,21600,600,60,528,22788,0.055
Breakdown,21600,600,300,8180,30680,0.42037037037037
Breakdown,21600,600,240,4928,27368,0.267037037037037
Breakdown,21600,600,150,2984,25334,0.17287037037037
Breakdown,21600,600,180,5408,27788,0.286481481481481
Breakdown,21600,600,120,3140,25460,0.178703703703704
Breakdown,21600,600,210,9102,31512,0.458888888888889
Breakdown,21600,600,90,1016,23306,0.078981481481482
Breakdown,21600,600,270,7838,30308,0.403148148148148
Breakdown,21600,600,150,2992,25342,0.173240740740741
Breakdown,21600,600,150,3456,25806,0.194722222222222
Breakdown,21600,600,270,7048,29518,0.366574074074074
Breakdown,21600,600,270,5872,28342,0.31212962962963
Breakdown,21600,600,180,4474,26854,0.243240740740741
Breakdown,21600,600,180,6866,29246,0.353981481481481
Breakdown,21600,600,270,8964,31434,0.455277777777778
Breakdown,21600,600,300,10410,32910,0.523611111111111
Breakdown,21600,656,152,4210,26618,0.232314814814815
Breakdown,21600,600,240,6256,28696,0.328518518518519
Breakdown,21600,628,182,6366,28776,0.332222222222222
Breakdown,21600,600,60,670,22930,0.061574074074074
Breakdown,21600,600,240,5612,28052,0.298703703703704
Breakdown,21600,600,120,3674,25994,0.203425925925926
Breakdown,21600,600,210,4828,27238,0.261018518518519
Breakdown,21600,600,270,6664,29134,0.348796296296296
Breakdown,21600,600,120,3348,25668,0.188333333333333
Breakdown,21600,600,180,3892,26272,0.216296296296296
Breakdown,21600,600,210,6564,28974,0.341388888888889
Breakdown,21600,600,180,4334,26714,0.236759259259259
Breakdown,21600,600,180,2490,24870,0.151388888888889
Breakdown,21600,600,120,2762,25082,0.161203703703704
Breakdown,21600,600,150,2782,25132,0.163518518518519
Breakdown,21600,600,210,6004,28414,0.315462962962963
Breakdown,21600,600,240,7710,30150,0.395833333333333
Breakdown,21600,600,330,7546,30076,0.392407407407407
Breakdown,21600,600,300,7354,29854,0.38212962962963
Breakdown,21600,654,242,5620,28116,0.301666666666667
Breakdown,21600,600,210,6278,28688,0.328148148148148
Breakdown,21600,600,270,8034,30504,0.412222222222222
Breakdown,21600,600,330,6378,28908,0.338333333333333
Breakdown,21600,600,150,5148,27498,0.273055555555556
Breakdown,21600,600,270,7396,29866,0.382685185185185
Breakdown,21600,600,270,10306,32776,0.517407407407407
Breakdown,21600,600,300,8012,30512,0.412592592592593
Breakdown,21600,600,270,6088,28558,0.32212962962963
Breakdown,21600,600,210,4202,26612,0.232037037037037
Breakdown,21600,600,360,6530,29090,0.346759259259259
Breakdown,21600,600,270,6944,29414,0.361759259259259
Breakdown,21600,640,62,426,22728,0.052222222222222
Breakdown,21600,600,270,9664,32134,0.487685185185185
Breakdown,21600,600,240,8296,30736,0.422962962962963
Breakdown,21600,600,180,8568,30948,0.432777777777778
Breakdown,21600,600,330,9894,32424,0.501111111111111
Breakdown,21600,600,120,3630,25950,0.201388888888889
Breakdown,21600,656,214,5878,28348,0.312407407407407
Breakdown,21600,632,392,8436,31060,0.437962962962963
Breakdown,21600,600,120,1154,23474,0.086759259259259
Breakdown,21600,600,300,8390,30890,0.430092592592593
Breakdown,21600,600,240,6152,28592,0.323703703703704
Breakdown,21600,628,242,6906,29376,0.36
Breakdown,21600,600,210,7282,29692,0.37462962962963
Breakdown,21600,600,150,2976,25326,0.1725
Breakdown,21600,600,270,7620,30090,0.393055555555556
Breakdown,21600,600,90,2172,24462,0.1325
Breakdown,21600,600,240,5668,28108,0.301296296296296
Breakdown,21600,606,212,3316,25734,0.191388888888889
Breakdown,21600,600,330,6436,28966,0.341018518518518
Breakdown,21600,600,270,6532,29002,0.342685185185185
Breakdown,21600,600,180,3876,26256,0.215555555555556
Breakdown,21600,686,394,13130,35810,0.65787037037037
Breakdown,21600,600,150,3464,25814,0.195092592592593
Breakdown,21600,600,300,6026,28526,0.320648148148148
Breakdown,21600,600,300,8358,30858,0.428611111111111
Breakdown,21600,600,360,9790,32350,0.497685185185185
Breakdown,21600,600,360,13820,36380,0.684259259259259
Breakdown,21600,600,180,3802,26182,0.21212962962963
Breakdown,21600,600,270,9636,32106,0.486388888888889
Breakdown,21600,642,242,8464,30948,0.432777777777778
Breakdown,21600,600,270,5956,28426,0.316018518518519
Breakdown,21600,600,120,3720,26040,0.205555555555556
Breakdown,21600,600,240,7642,30082,0.392685185185185
Breakdown,21600,600,180,3734,26114,0.208981481481481
Breakdown,21600,600,210,6108,28518,0.320277777777778
Breakdown,21600,600,210,4740,27150,0.256944444444444
Breakdown,21600,600,240,7674,30114,0.394166666666667
Breakdown,21600,600,60,350,22610,0.046759259259259
Breakdown,21600,600,150,4778,27128,0.255925925925926
Breakdown,21600,600,120,3786,26106,0.208611111111111
Breakdown,21600,600,210,3536,25946,0.201203703703704
Breakdown,21600,600,210,6582,28992,0.342222222222222
Breakdown,21600,600,120,3262,25582,0.184351851851852
Breakdown,21600,600,150,2438,24788,0.147592592592593
Breakdown,21600,600,240,6934,29374,0.359907407407407
Breakdown,21600,600,240,5460,27900,0.291666666666667
Breakdown,21600,600,210,8146,30556,0.41462962962963
Breakdown,21600,600,180,4170,26550,0.229166666666667
Breakdown,21600,600,240,5378,27818,0.28787037037037
Breakdown,21600,600,420,9510,32130,0.4875
Breakdown,21600,600,150,3290,25640,0.187037037037037
Breakdown,21600,600,210,4354,26764,0.239074074074074
Breakdown,21600,600,210,6654,29064,0.345555555555556
Breakdown,21600,600,270,6392,28862,0.336203703703704
Breakdown,21600,600,180,5792,28172,0.304259259259259
Breakdown,21600,600,150,2986,25336,0.172962962962963
Breakdown,21600,600,180,4758,27138,0.256388888888889
Breakdown,21600,600,120,3866,26186,0.212314814814815
Breakdown,21600,600,180,7406,29786,0.378981481481481
Breakdown,21600,600,240,6232,28672,0.327407407407407
Breakdown,21600,600,210,4512,26922,0.246388888888889
Breakdown,21600,600,210,4706,27116,0.25537037037037
Breakdown,21600,600,270,4094,26564,0.229814814814815
Breakdown,21600,600,300,8188,30688,0.420740740740741
Breakdown,21600,600,150,4682,27032,0.251481481481481
Breakdown,21600,600,90,634,22924,0.061296296296296
Breakdown,21600,618,92,2820,25130,0.163425925925926
Breakdown,21600,638,152,4190,26580,0.230555555555556
Breakdown,21600,602,302,5824,28328,0.311481481481481
Breakdown,21600,600,360,10998,33558,0.553611111111111
Breakdown,21600,600,300,8142,30642,0.418611111111111
Breakdown,21600,600,300,11292,33792,0.564444444444444
Breakdown,21600,600,60,340,22600,0.046296296296296
Breakdown,21600,600,330,4206,26736,0.237777777777778
Breakdown,21600,638,92,3994,26324,0.218703703703704
Breakdown,21600,600,450,13086,35736,0.654444444444444
Breakdown,21600,600,390,12760,35350,0.636574074074074
Breakdown,21600,600,150,3214,25564,0.183518518518519
Breakdown,21600,600,180,5126,27506,0.273425925925926
Breakdown,21600,600,150,3672,26022,0.204722222222222
Breakdown,21600,600,240,7812,30252,0.400555555555556
Breakdown,21600,600,480,12008,34688,0.605925925925926
Breakdown,21600,600,120,4348,26668,0.23462962962963
Breakdown,21600,600,210,5712,28122,0.301944444444444
Breakdown,21600,600,180,4728,27108,0.255
Breakdown,21600,600,300,7332,29832,0.381111111111111
Breakdown,21600,600,180,4756,27136,0.256296296296296
Breakdown,21600,600,180,4222,26602,0.231574074074074
Breakdown,21600,600,390,11644,34234,0.584907407407407
Breakdown,21600,600,150,3940,26290,0.21712962962963
Breakdown,21600,600,240,3806,26246,0.215092592592593
Breakdown,21600,602,182,5426,27810,0.2875
Breakdown,21600,600,540,16606,39346,0.821574074074074
Breakdown,21600,600,210,5616,28026,0.2975
Breakdown,21600,600,210,6330,28740,0.330555555555556
Breakdown,21600,600,240,3970,26410,0.222685185185185
Breakdown,21600,600,210,6928,29338,0.358240740740741
Breakdown,21600,600,180,3552,25932,0.200555555555555
Breakdown,21600,600,300,7074,29574,0.369166666666667
Breakdown,21600,638,332,10534,33104,0.532592592592593
Breakdown,21600,600,150,4914,27264,0.262222222222222
Breakdown,21600,600,240,10402,32842,0.520462962962963
Breakdown,21600,600,390,16018,38608,0.787407407407407
Breakdown,21600,618,122,4148,26488,0.226296296296296
Breakdown,21600,600,90,2352,24642,0.140833333333333
Breakdown,21600,600,480,11832,34512,0.597777777777778
Breakdown,21600,600,150,4184,26534,0.228425925925926
Breakdown,21600,600,240,5618,28058,0.298981481481481
Breakdown,21600,600,240,6692,29132,0.348703703703704
Breakdown,21600,600,240,7368,29808,0.38
Breakdown,21600,600,330,7872,30402,0.4075
Breakdown,21600,638,182,5312,27732,0.283888888888889
Breakdown,21600,600,240,4880,27320,0.264814814814815
Breakdown,21600,600,120,3102,25422,0.176944444444444
Breakdown,21600,600,90,942,23232,0.075555555555556
Breakdown,21600,600,300,8884,31384,0.452962962962963
Breakdown,21600,600,600,18884,41684,0.929814814814815
Breakdown,21600,600,180,5524,27904,0.291851851851852
Breakdown,21600,600,360,10946,33506,0.551203703703704
Breakdown,21600,600,240,7558,29998,0.388796296296296
Breakdown,21600,600,450,10786,33436,0.547962962962963
Breakdown,21600,600,420,13670,36290,0.680092592592593
Breakdown,21600,600,180,5166,27546,0.275277777777778
Breakdown,21600,600,90,1906,24196,0.120185185185185
Breakdown,21600,600,300,10954,33454,0.548796296296296
Breakdown,21600,600,420,12894,35514,0.644166666666667
Breakdown,21600,600,240,7446,29886,0.383611111111111
Breakdown,21600,600,330,8620,31150,0.44212962962963
Breakdown,21600,600,30,436,22666,0.049351851851852
Breakdown,21600,600,450,12544,35194,0.629351851851852
Breakdown,21600,600,360,10682,33242,0.538981481481482
Breakdown,21600,610,272,8832,31314,0.449722222222222
Breakdown,21600,600,330,10882,33412,0.546851851851852
Breakdown,21600,600,150,4086,26436,0.223888888888889
Breakdown,21600,600,210,7144,29554,0.368240740740741
Breakdown,21600,600,150,3990,26340,0.219444444444444
Breakdown,21600,600,330,8228,30758,0.423981481481482
Breakdown,21600,600,120,2784,25104,0.162222222222222
Breakdown,21600,600,240,7474,29914,0.384907407407407
Breakdown,21600,600,300,5570,28070,0.299537037037037
Breakdown,21600,600,60,474,22734,0.0525
Breakdown,21600,600,150,5842,28192,0.305185185185185
Breakdown,21600,600,330,9320,31850,0.474537037037037
Breakdown,21600,600,90,2894,25184,0.165925925925926
Breakdown,21600,600,300,9672,32172,0.489444444444444
Breakdown,21600,600,360,8648,31208,0.444814814814815
Breakdown,21600,600,210,3476,25886,0.198425925925926
Breakdown,21600,600,210,7220,29630,0.371759259259259
Breakdown,21600,652,122,3058,25432,0.177407407407407
Breakdown,21600,600,330,9490,32020,0.482407407407407
Breakdown,21600,600,60,490,22750,0.053240740740741
Breakdown,21600,600,30,370,22600,0.046296296296296
Breakdown,21600,600,210,5708,28118,0.301759259259259
Breakdown,21600,600,180,7776,30156,0.396111111111111
Breakdown,21600,600,300,5976,28476,0.318333333333333
Breakdown,21600,634,272,5774,28280,0.309259259259259
Breakdown,21600,600,300,7972,30472,0.410740740740741
Breakdown,21600,654,212,4740,27206,0.259537037037037
Breakdown,21600,600,360,9994,32554,0.50712962962963
Breakdown,21600,600,210,5086,27496,0.272962962962963
Breakdown,21600,600,210,6800,29210,0.352314814814815
Breakdown,21600,600,150,3978,26328,0.218888888888889
Breakdown,21600,636,182,2800,25218,0.1675
Breakdown,21600,614,272,8050,30536,0.413703703703704
Breakdown,21600,602,92,1780,24074,0.114537037037037
Breakdown,21600,600,420,10132,32752,0.516296296296296
Breakdown,21600,600,240,5152,27592,0.277407407407407
Breakdown,21600,600,570,15378,38148,0.766111111111111
Breakdown,21600,600,180,2594,24974,0.156203703703704
Breakdown,21600,600,120,2008,24328,0.126296296296296
Breakdown,21600,600,180,5030,27410,0.268981481481481
Breakdown,21600,600,120,3760,26080,0.207407407407407
Breakdown,21600,600,180,5342,27722,0.283425925925926
Breakdown,21600,600,90,2400,24690,0.143055555555556
Breakdown,21600,600,150,4564,26914,0.246018518518518
Breakdown,21600,600,270,6340,28810,0.333796296296296
Breakdown,21600,628,242,7658,30128,0.394814814814815
Breakdown,21600,600,270,6336,28806,0.333611111111111
,,,,,,
min,21600,600,30,0,22230,0.029166666666667
avg,21600,605.272,227.202,6402.748,28835.222,0.334963981481482
max,21600,708,780,25638,48618,1.25083333333333
